 +-------+-------+
 |.......|.......|
 |...............|
 |.......|.......|
 |.......|.......|
 E.......|.......|
 |.......|.......|
 |.......|.......|
 |.......|.......|
 |........S......|
 +-------+-------+
